M   ###########
### ###### ####
###        ####
#   ### #### ##
# ##### #### ##
#     #      ##
####### # #####
##### ###    ##
##### ### ## ##
###       ##   
### ########## 
###      ##### 
###### ####### 
######      ###
##########    G
